12 16
################
# *#     #     #
#  ###         #
#  #     #  ####
#        #     #
#  #### ##### ##
#              #
#  #   # # #   #
#  # # # # #  ##
#  # #         #
#      # # #  ##
################
3 16
################
#*             #
################
5 8
########
#*     #
#      #
#      #
######## 
3 9
#########
#*      #
#########
0 0
